########
#      #
# .  . #
#  $ $ #
# .  . #
#   @  #
########
